20
cat
#W#####
CWP####
#W#W###
#W#M###
#W#####
#WWWW##
#######
