20
cat
P######
#######
M##WC##
##WWW##
###W###
#######
#######
