20
cat
#######
#####P#
#######
##WW###
##MW###
#######
##C####
