20
mouse
###P###
#######
###W###
##WWW##
###W###
######W
M###W#C