20
cat
#######
##PW###
###M###
#######
#######
##WWW##
###C###
