20
mouse
P######
#W###M#
#W#####
#WC####
#######
#######
#######
