20
mouse
#P#####
####M##
#######
####W##
##WWW##
###C###
#######
