20
mouse
#######
#M#P###
#######
WWWWWWW
C######
#######
#######
